4 72 95 72 853 92 853 92 95 
4 200 95 200 851 220 851 220 95 
4 37 41 37 64 55 64 55 41 
4 67 53 67 83 85 83 85 53 
4 209 33 209 41 427 41 427 33 
4 315 354 315 369 1159 369 1159 354 
4 314 475 314 488 1157 488 1157 475 
6 317 739 317 759 990 759 990 844 1004 844 1004 742 
6 320 657 1096 657 1096 838 1109 838 1109 646 321 646 
