4 72 803 142 803 142 117 72 117 
4 249 118 249 801 330 801 330 118 
4 402 126 402 176 1139 176 1139 126 
4 400 264 400 319 1136 319 1136 264 
4 400 405 400 456 1137 456 1137 405 
4 413 637 413 700 1133 700 1133 637 
