5 374 172 345 209 396 264 449 226 421 184 
5 555 176 536 214 572 252 653 237 639 165 
5 789 173 754 206 791 241 836 233 858 187 
5 383 352 367 406 400 436 474 412 474 365 
5 584 356 545 405 590 441 647 415 640 362 
6 773 361 741 396 774 428 838 430 863 393 826 349 
5 390 544 375 597 419 634 489 601 463 547 
5 604 543 566 594 609 632 682 611 670 554 
5 797 556 774 597 816 638 879 606 863 566 
5 393 712 383 752 418 787 472 759 461 712 
6 588 706 575 748 606 776 657 765 674 718 639 696 
6 811 698 781 723 799 771 856 770 888 729 864 694 
4 223 175 207 211 238 251 295 240 
5 229 369 215 407 253 433 315 428 308 365 
5 232 557 210 618 256 647 305 619 313 564 
5 257 714 236 755 259 784 305 781 317 722 
5 974 171 939 200 970 241 1013 227 1032 184 
5 952 341 916 381 948 423 1021 410 1015 357 
5 961 551 936 589 992 625 1044 574 1012 513 
5 979 699 946 739 991 761 1043 751 1040 695 
4 225 72 209 109 272 118 293 78 
4 379 77 366 109 408 115 455 80 
4 554 73 572 113 624 105 648 76 
4 764 89 788 121 838 106 842 69 
4 949 66 971 99 1009 98 1024 68 
