16 127 111 127 385 272 386 268 349 162 348 168 157 312 158 313 186 339 184 338 162 461 165 457 339 343 348 347 379 508 376 510 115 
27 626 117 616 374 752 378 753 342 707 339 661 337 663 293 662 247 663 194 661 153 726 155 851 157 851 255 878 252 886 160 940 162 941 345 862 344 865 375 987 367 987 284 1116 283 1110 254 986 249 985 161 1114 151 1111 122 
6 127 511 126 687 178 684 178 558 288 549 286 504 
12 123 756 123 827 520 824 873 821 1086 819 1079 493 387 500 386 547 1025 542 1029 783 172 789 177 755 
4 569 636 563 710 852 699 847 637 
