77 104 105 121 125 107 136 121 154 107 163 110 205 125 208 125 225 108 227 108 256 129 267 131 287 105 297 112 329 130 339 132 365 112 382 114 424 220 424 221 384 195 364 197 321 260 317 259 277 198 276 198 200 310 203 310 169 220 171 223 133 264 141 279 123 303 143 356 142 417 136 416 206 432 221 416 230 418 257 481 260 485 215 456 190 453 160 478 142 508 137 554 142 553 178 563 203 570 206 598 211 616 203 628 190 630 173 627 152 622 133 611 116 597 102 577 90 561 86 539 83 526 91 516 103 511 112 499 116 470 111 459 94 444 78 418 80 398 84 383 98 371 106 330 98 297 88 225 91 201 116 175 103 128 76 
13 425 343 408 350 401 363 398 381 403 392 413 406 427 411 462 411 477 394 485 375 477 351 457 337 441 340 
11 241 491 197 545 285 603 305 592 306 616 372 662 424 594 353 541 332 548 328 524 255 478 
14 522 440 476 500 549 544 610 449 601 424 627 424 675 349 648 327 626 343 625 315 601 306 555 382 560 406 540 411 
16 692 542 704 571 675 580 667 603 788 647 812 633 816 653 913 688 923 655 910 630 933 625 943 596 843 555 821 571 814 545 701 509 
4 737 831 735 858 774 856 774 827 
4 1007 819 1005 853 1041 850 1039 819 
6 402 737 448 778 404 810 624 787 582 755 611 712 
4 298 831 297 856 330 858 335 816 
7 777 717 756 736 758 756 774 772 794 768 807 747 795 723 
6 1035 584 1044 644 1085 644 1071 615 1090 600 1088 586 
4 1069 456 1069 501 1109 499 1105 457 
4 1073 363 1072 406 1106 410 1105 367 
4 1073 270 1072 313 1115 313 1112 268 
25 819 201 822 259 843 271 824 285 841 298 826 308 827 373 847 388 873 390 887 364 904 393 928 389 944 376 941 301 924 284 945 273 922 257 938 241 935 173 911 144 882 141 872 168 854 138 820 139 809 164 
4 725 399 726 434 766 434 765 402 
3 894 470 926 513 949 465 
4 698 202 698 239 736 240 736 202 
13 122 648 129 710 151 724 134 747 144 815 237 803 220 736 197 719 218 701 206 639 168 645 164 665 150 646 
4 80 796 80 820 100 822 100 796 
4 99 516 103 559 141 556 145 516 
4 1022 114 1023 153 1060 147 1061 113 
4 826 72 829 95 859 93 859 72 
3 323 306 327 330 348 305 
4 507 632 510 665 548 664 556 628 
4 1001 735 1012 764 1037 747 1031 714 
