14 149 129 148 353 323 352 325 223 539 220 543 121 461 121 458 90 422 88 420 120 278 120 276 83 250 80 245 116 
22 588 117 588 133 669 129 669 220 852 220 850 175 959 180 963 270 1065 264 1062 108 1008 106 1007 134 980 132 978 107 953 109 954 127 930 127 923 108 906 111 904 134 868 134 866 110 
20 534 420 532 474 570 473 568 510 533 510 527 557 588 563 592 522 619 521 619 563 679 560 681 510 640 508 641 469 682 466 681 414 626 414 616 459 592 461 590 416 
18 141 437 143 662 248 661 244 768 134 774 132 829 410 814 411 772 544 765 538 744 413 748 414 607 260 614 261 449 452 451 451 399 431 399 425 433 
4 623 661 622 704 660 700 664 663 
4 805 561 804 604 842 601 842 563 
4 853 394 852 443 903 442 902 397 
4 699 778 696 815 733 812 734 774 
4 798 813 842 810 838 769 799 772 
4 899 767 898 805 946 804 945 770 
4 997 769 995 806 1029 803 1035 770 
4 1040 370 1038 666 1072 663 1077 370 
