9 103 139 132 170 99 192 108 230 146 238 154 202 198 194 197 157 167 131 
8 279 120 284 164 254 192 250 260 281 232 314 198 375 207 344 144 
4 381 74 412 110 447 84 427 66 
5 519 97 490 131 493 196 553 153 539 109 
4 654 127 700 129 684 89 607 91 
7 803 49 748 61 801 76 805 217 849 154 831 89 883 79 
32 978 126 998 185 942 184 945 224 995 224 1001 285 942 281 945 317 999 312 997 356 941 359 916 398 865 390 855 413 876 476 899 429 980 441 955 485 1023 472 1003 405 1044 387 1086 418 1080 364 1056 357 1087 331 1053 307 1092 306 1056 257 1095 255 1064 221 1107 218 1076 183 
7 1066 78 1098 126 1108 109 1129 133 1133 88 1077 57 1028 62 
3 1087 497 1113 534 1131 506 
13 536 473 507 491 486 528 494 585 528 625 592 622 608 598 617 543 577 544 541 534 566 506 612 504 601 475 
14 639 391 676 424 676 472 675 515 705 528 701 577 718 622 752 610 737 554 721 481 769 497 766 458 720 437 697 394 
4 723 323 767 367 783 329 754 310 
15 133 368 181 399 132 425 136 453 258 452 275 432 291 456 402 451 408 422 353 403 407 384 401 356 279 360 269 381 246 360 
4 440 330 479 368 510 329 478 294 
12 595 258 607 274 583 277 620 321 631 311 637 323 690 285 672 273 689 265 655 217 642 226 631 214 
3 902 577 923 712 949 583 
3 1086 739 937 758 1083 793 
4 1104 662 1125 684 1136 660 1122 641 
3 723 739 720 781 867 756 
3 905 793 887 848 926 849 
13 391 677 424 726 398 758 453 749 440 794 499 772 480 817 539 814 567 756 488 729 487 692 454 668 386 655 
4 105 805 141 842 177 812 162 760 
8 235 816 261 851 286 824 310 850 336 815 308 781 285 799 251 781 
4 170 536 113 590 258 717 309 663 
4 75 502 63 539 84 545 101 516 
4 77 63 94 90 132 73 99 49 
4 609 824 638 849 656 822 639 807 
