5 125 152 119 210 161 215 148 170 167 142 
5 230 94 247 121 281 122 291 85 257 67 
5 130 331 140 376 175 389 202 356 176 297 
5 265 251 242 287 305 333 320 283 300 223 
5 443 202 397 244 438 268 477 232 476 192 
5 434 111 427 146 495 167 513 141 495 93 
5 575 135 570 182 610 196 682 183 648 124 
5 697 252 605 261 635 319 663 310 698 288 
5 694 368 721 407 756 402 760 353 733 332 
5 175 465 199 528 290 577 322 543 270 511 
5 384 565 442 604 578 626 589 565 517 554 
5 517 440 539 473 576 461 567 406 532 390 
5 347 442 363 480 414 478 415 437 394 407 
4 698 518 709 531 730 513 705 500 
4 690 627 700 641 723 626 702 604 
3 838 422 832 447 857 443 
4 820 307 824 327 842 324 845 302 
4 808 243 821 258 844 245 823 211 
5 742 116 759 140 791 132 786 93 753 85 
5 927 122 922 156 960 162 983 132 959 98 
11 909 345 926 369 952 372 952 422 933 446 908 479 920 519 939 539 953 483 994 443 985 386 
4 997 498 1009 526 1043 519 1020 484 
4 1026 371 1027 398 1059 388 1053 351 
5 975 253 984 274 1012 270 1016 228 986 201 
6 828 641 814 684 778 713 813 727 854 709 853 679 
6 445 730 495 749 524 731 507 707 423 702 411 726 
4 796 557 806 579 822 571 820 548 
4 887 588 910 615 931 594 912 572 
5 966 661 982 682 1009 674 1007 648 976 653 
4 809 765 823 792 848 784 848 763 
5 537 799 568 829 633 816 644 788 598 784 
9 114 650 116 698 178 749 229 722 208 701 183 710 183 681 157 692 150 666 
4 130 810 182 838 250 831 216 808 
4 287 758 311 778 329 762 306 740 
5 329 668 356 684 368 648 333 642 308 650 
4 116 536 124 587 149 586 135 557 
4 260 405 280 409 283 396 268 393 
4 441 345 465 358 474 337 462 335 
5 861 86 861 103 881 96 883 80 870 72 
6 1051 148 1070 191 1065 227 1095 210 1098 152 1069 137 
4 1109 408 1106 452 1123 448 1129 404 
5 1060 594 1067 623 1085 619 1095 590 1081 574 
3 645 715 671 738 689 715 
9 919 787 936 814 991 800 1027 767 1060 823 1075 762 1020 739 981 739 975 772 
4 1081 698 1104 720 1116 694 1092 681 
4 736 834 763 842 766 820 741 809 
3 321 138 330 151 343 143 
4 81 296 86 315 106 280 81 277 
5 416 832 436 838 439 820 412 811 398 823 
3 631 474 644 483 644 464 