57 121 129 120 190 161 192 157 221 120 219 115 262 152 255 148 286 127 298 121 318 134 340 153 344 153 377 148 412 107 424 109 459 222 458 213 403 190 390 194 305 244 309 241 280 202 282 212 173 372 176 372 215 346 212 342 245 372 243 360 361 385 357 385 313 437 309 426 280 390 278 397 185 495 185 496 233 551 234 559 145 554 120 531 132 515 123 510 140 487 122 475 144 462 121 447 144 426 122 351 121 347 145 331 123 323 142 314 120 300 149 283 111 158 121 
10 636 127 699 248 721 240 714 264 736 300 794 248 747 160 716 164 729 138 718 109 
31 831 90 832 156 902 149 903 185 930 182 927 142 1002 149 1003 290 939 284 935 352 1002 351 1077 316 1085 269 1059 263 1060 242 1081 237 1081 218 1061 213 1064 186 1083 176 1083 122 1055 115 1084 90 1026 82 1021 113 1004 109 1000 82 928 83 923 110 900 110 896 82 
7 636 376 592 433 732 525 769 510 758 538 819 589 879 505 
7 372 517 397 627 424 632 403 646 419 739 517 712 479 491 
16 687 659 683 744 761 763 766 736 794 735 788 760 879 758 885 730 905 731 904 760 971 755 976 670 896 666 882 688 730 686 723 662 
12 130 606 156 711 123 722 133 752 164 744 188 827 273 805 248 722 280 706 271 680 236 687 216 582 
4 504 798 502 836 553 832 552 796 
8 1012 443 1007 563 1036 563 1037 529 1073 527 1071 498 1038 495 1045 446 
4 1030 792 1029 829 1068 828 1069 789 
7 598 565 585 576 593 601 618 616 648 598 652 569 638 552 
13 821 341 809 351 807 365 809 378 819 386 833 391 851 385 860 371 860 355 855 345 847 337 836 334 829 333 
4 518 312 518 339 549 337 547 307 
4 302 439 301 464 331 464 334 436 
