10 109 108 109 378 290 376 288 204 422 204 419 156 518 155 516 203 623 199 622 103 
10 714 103 712 193 782 188 780 292 889 281 885 185 1002 192 1006 475 1117 470 1115 104 
16 543 437 543 497 589 512 543 539 546 604 604 598 619 555 642 593 687 594 691 529 646 508 689 485 691 434 635 434 614 476 593 438 
4 107 464 106 547 416 538 415 458 
8 104 626 100 701 229 692 231 715 263 707 265 687 413 680 410 620 
8 104 784 103 838 414 834 415 777 360 776 360 762 333 761 330 776 
4 537 698 535 746 585 743 587 701 
4 647 699 645 742 690 740 689 699 
4 740 696 739 740 786 737 789 692 
4 836 692 836 735 882 734 882 689 
4 936 689 935 733 981 731 981 689 
4 826 554 821 612 1006 613 1011 555 
4 909 810 908 839 947 839 949 805 
4 577 318 577 355 619 355 619 316 
4 812 409 814 450 861 451 862 409 
