20 96 105 96 358 167 358 167 338 119 338 119 128 445 128 445 153 471 153 471 129 669 129 669 336 640 336 640 354 690 354 690 109 304 109 304 91 279 91 279 111 
4 220 337 220 355 585 355 585 337 
4 198 193 198 212 217 212 217 193 
4 258 194 258 213 277 213 277 194 
4 197 253 197 270 218 270 218 253 
4 259 250 259 271 280 271 280 250 
4 581 170 581 276 644 276 644 170 
4 421 211 421 226 436 226 436 211 
4 476 210 476 226 495 226 495 210 
4 421 265 421 276 436 276 436 265 
4 481 260 481 275 497 275 497 260 
14 829 120 829 368 849 368 849 290 891 290 891 272 851 272 851 139 1077 139 1077 342 949 342 949 364 1095 364 1095 122 
4 946 201 946 230 980 230 980 201 
4 1001 279 1001 300 1022 300 1022 279 
4 798 203 798 250 818 250 818 203 
4 706 265 706 327 725 327 725 265 
4 93 541 93 791 111 791 111 541 
6 171 769 171 790 412 790 412 676 389 676 389 770 
4 165 543 165 564 417 564 417 543 
4 328 472 328 531 380 531 380 472 
4 263 504 263 529 295 529 295 504 
4 481 372 481 414 544 414 544 372 
4 183 617 183 698 197 698 197 617 
4 220 631 220 641 231 641 231 631 
4 253 631 253 640 263 640 263 631 
4 219 673 219 683 228 683 228 673 
4 253 671 253 681 262 681 262 671 
4 420 716 420 729 429 729 429 716 
4 456 717 456 726 465 726 465 717 
4 420 761 420 772 429 772 429 761 
4 461 756 461 770 469 770 469 756 
4 304 726 304 759 377 759 377 726 
4 516 523 516 591 584 591 584 523 
4 403 573 412 632 429 627 418 568 
4 581 361 585 422 589 419 586 362 
4 706 774 706 790 1088 790 1088 774 
4 1065 519 1065 702 1086 702 1086 519 
10 706 708 729 708 729 538 988 538 988 520 709 520 709 621 665 621 665 639 708 639 
4 806 548 806 589 860 589 860 548 
4 915 550 915 588 966 588 966 550 
4 805 660 805 670 812 670 812 660 
4 853 659 853 670 861 670 861 659 
4 803 699 803 707 810 707 810 699 
4 852 698 852 708 862 708 862 698 
4 905 635 905 646 913 646 913 635 
4 949 633 949 645 960 645 960 633 
4 904 726 904 736 912 736 912 726 
4 953 721 953 732 961 732 961 721 
4 934 677 934 701 947 701 947 677 
4 1036 600 1036 671 1054 671 1054 600 
4 824 462 824 512 903 512 903 462 
4 715 498 715 512 733 512 733 498 
4 93 428 93 439 102 439 102 428 
4 131 426 131 437 142 437 142 426 
4 540 822 540 862 631 862 631 822 
4 647 836 647 861 687 861 687 836 
4 1121 426 1121 484 1160 484 1160 426 
4 77 847 77 862 136 862 136 847 
4 743 43 743 65 821 65 821 43 
4 1007 35 1007 54 1025 54 1025 35 
4 111 37 111 48 134 48 134 37 
4 1026 799 1026 827 1054 827 1054 799 
4 265 795 265 814 283 814 283 795 
4 1018 369 1018 385 1037 385 1037 369 
4 1155 131 1155 151 1166 151 1166 131 
4 1100 212 1100 295 1110 295 1110 212 
4 530 35 530 51 604 51 604 35 
4 32 245 32 258 42 258 42 245 
4 31 644 31 661 42 661 42 644 
4 227 85 227 99 241 99 241 85 
4 292 363 292 376 389 376 389 363 
