43 111 206 110 245 158 248 155 341 112 344 110 375 182 375 228 371 227 343 184 343 187 260 231 263 233 228 187 226 193 155 295 156 311 192 330 161 381 164 384 235 347 236 341 275 385 267 379 346 297 345 297 374 444 370 442 341 403 341 404 265 450 266 446 238 409 236 417 94 382 94 380 129 235 123 233 80 203 79 202 113 162 116 155 201 154 209 
55 115 498 115 529 180 529 173 615 113 614 112 645 173 640 169 735 101 738 101 770 165 763 162 831 193 827 195 765 287 771 285 830 313 825 315 773 397 762 396 823 423 821 421 758 487 759 484 730 423 728 423 642 490 637 488 608 422 612 417 522 507 521 499 484 412 488 411 425 378 429 386 486 279 489 280 524 379 522 381 606 261 608 262 644 374 637 379 726 321 728 301 696 273 727 199 726 199 687 210 670 199 647 202 527 198 488 180 461 160 489 
54 534 350 566 383 661 277 715 292 684 250 731 254 710 218 752 160 827 171 808 195 840 215 859 187 924 230 915 256 942 273 955 255 980 278 975 302 906 403 865 370 844 400 887 433 797 537 737 488 717 521 792 589 833 575 855 537 924 581 949 540 881 504 917 444 987 479 1010 441 939 412 979 343 1052 236 1022 212 991 241 923 196 955 142 929 130 894 172 824 117 772 129 724 105 707 128 719 150 673 208 618 169 605 198 642 226 559 325 509 305 
11 779 277 715 346 730 367 698 388 681 370 651 426 683 442 738 420 806 321 824 322 834 308 
4 1063 361 1059 401 1136 401 1129 360 
4 1066 88 1061 137 1139 139 1137 86 
4 857 55 855 80 894 84 895 56 
4 505 92 506 126 549 127 553 94 
4 620 65 618 98 656 101 660 65 
4 71 74 72 105 109 109 111 78 
33 614 649 556 651 555 679 607 682 604 747 629 753 628 815 667 817 666 756 764 763 760 819 790 822 798 762 939 769 934 822 965 821 972 766 1074 772 1075 744 1010 738 1012 688 971 685 964 737 879 738 877 687 843 688 841 736 732 733 738 699 697 698 695 729 630 724 639 648 
4 1036 586 1036 623 1072 627 1073 586 
4 1102 490 1100 523 1131 524 1135 493 
4 1109 679 1108 704 1133 704 1134 679 
