93 138 117 138 429 156 429 156 242 310 242 310 281 357 281 357 343 308 343 308 364 297 364 297 384 306 384 306 412 287 412 287 424 310 424 310 467 357 467 357 538 310 538 310 582 290 582 290 603 310 603 310 633 358 633 358 704 313 704 313 749 159 749 159 564 135 564 135 770 547 770 547 737 507 737 507 618 531 618 531 635 562 635 562 619 645 619 645 641 638 641 638 659 645 659 645 674 670 674 670 621 867 621 867 737 671 737 671 722 650 722 650 735 579 735 579 771 908 771 908 732 950 732 950 768 1063 768 1063 397 1039 397 1039 554 561 554 561 268 1033 268 1033 303 1063 303 1063 226 1014 226 1014 175 1063 175 1063 121 920 121 920 138 968 138 968 234 724 234 724 144 798 144 798 120 484 120 484 145 528 145 528 287 380 287 380 150 380 142 442 142 442 121 
4 435 203 435 242 476 242 476 203 
4 506 153 506 168 519 168 519 153 
4 793 210 793 227 830 227 830 210 
4 863 210 863 227 914 227 914 210 
4 944 157 944 196 960 196 960 157 
4 733 172 733 187 750 187 750 172 
4 1021 185 1021 214 1036 214 1036 185 
4 589 272 589 299 645 299 645 272 
4 703 270 703 300 759 300 759 270 
4 816 271 816 301 867 301 867 271 
4 923 273 923 300 988 300 988 273 
4 591 426 591 434 599 434 599 426 
4 626 426 626 434 634 434 634 426 
4 591 460 591 467 598 467 598 460 
4 628 457 628 467 636 467 636 457 
4 582 489 582 496 646 496 646 489 
4 716 424 716 434 726 434 726 424 
4 756 421 756 433 767 433 767 421 
4 714 460 714 469 725 469 725 460 
4 760 461 760 473 769 473 769 461 
4 700 487 700 496 789 496 789 487 
4 841 414 841 425 850 425 850 414 
4 879 416 879 424 885 424 885 416 
4 844 460 844 468 855 468 855 460 
4 884 461 884 469 890 469 890 461 
4 832 485 832 493 906 493 906 485 
4 969 421 969 495 980 495 980 421 
4 750 523 750 532 762 532 762 523 
4 922 526 922 537 944 537 944 526 
4 581 331 581 350 594 350 594 331 
4 793 347 793 363 810 363 810 347 
4 1016 431 1016 444 1028 444 1028 431 
4 738 629 738 646 791 646 791 629 
4 839 707 839 729 858 729 858 707 
4 513 679 513 705 525 705 525 679 
4 168 721 168 738 188 738 188 721 
4 165 329 165 350 181 350 181 329 
4 207 251 207 268 235 268 235 251 
4 203 87 203 111 286 111 286 87 
4 601 34 601 53 682 53 682 34 
4 668 101 668 112 681 112 681 101 
4 979 38 979 56 1021 56 1021 38 
4 381 37 381 49 402 49 402 37 
4 36 35 36 63 64 63 64 35 
4 36 179 36 266 48 266 48 179 
4 118 258 118 276 128 276 128 258 
4 37 590 37 616 51 616 51 590 
4 105 705 105 725 126 725 126 705 
4 148 851 148 863 250 863 250 851 
4 356 850 356 863 475 863 475 850 
4 721 776 721 793 746 793 746 776 
4 828 844 828 865 856 865 856 844 
4 1097 836 1097 864 1129 864 1129 836 
4 1070 667 1070 710 1085 710 1085 667 
4 1154 409 1154 425 1165 425 1165 409 
4 1157 152 1157 167 1166 167 1166 152 
4 1068 151 1068 164 1077 164 1077 151 
4 1072 276 1072 299 1084 299 1084 276 
4 1069 498 1069 516 1084 516 1084 498 
