14 259 302 169 322 155 376 218 409 253 430 213 457 147 478 138 519 174 542 246 495 299 452 278 393 218 364 268 338 
12 329 310 316 529 455 527 450 483 357 482 360 428 399 420 400 390 364 380 371 338 455 334 464 303 
10 503 308 483 528 521 529 525 395 577 525 618 525 632 302 594 301 580 457 535 309 
8 656 301 653 337 711 335 701 518 732 515 740 331 782 331 776 292 
4 814 299 794 510 834 507 858 298 
10 897 306 877 506 908 507 916 397 960 507 1002 500 1018 303 978 303 964 436 931 305 
12 414 579 390 758 521 747 530 705 426 721 440 666 494 660 501 628 451 626 450 588 530 590 536 557 
6 747 553 703 757 848 752 851 713 754 710 790 563 
10 304 147 350 180 329 232 395 204 445 239 434 167 495 148 421 127 396 70 367 126 
4 767 114 772 188 952 179 948 107 
