5 279 151 264 210 299 220 322 175 319 147 
6 435 188 441 251 511 243 535 204 632 239 659 206 
4 635 295 642 339 724 321 739 281 
5 866 222 868 338 917 346 937 266 904 234 
6 658 468 612 483 634 567 723 565 685 485 719 480 
5 815 485 815 538 896 544 906 485 861 438 
5 363 388 353 437 391 479 488 452 493 413 
5 228 349 208 397 237 456 306 408 296 334 
7 122 246 98 299 121 358 98 389 88 429 113 481 149 346 
5 108 631 128 692 191 715 276 598 217 590 
10 336 680 395 784 448 761 543 698 559 770 589 749 559 673 455 647 416 690 355 631 
11 697 668 696 728 740 750 727 776 774 755 774 712 802 747 805 713 855 712 768 630 742 663 
5 900 631 883 666 936 695 953 659 950 629 
5 857 142 906 183 1015 155 981 114 891 101 
5 581 64 573 137 741 134 733 77 635 107 
4 361 56 407 113 462 87 418 58 
5 749 394 745 437 813 438 803 385 777 389 
8 981 403 1000 454 1088 486 1018 536 1014 572 1054 573 1108 480 1040 431 
4 503 551 515 570 536 562 546 534 
4 293 527 314 560 403 578 399 541 
6 563 373 571 398 620 406 592 438 652 406 618 382 
4 141 118 159 173 202 131 212 106 
6 1001 800 1021 806 1057 714 992 682 936 748 979 752 
