8 237 120 202 200 231 244 289 168 304 85 374 91 345 39 288 38 
7 648 160 647 223 708 257 718 192 711 134 779 98 652 76 
6 302 326 249 499 286 458 352 365 465 426 493 326 
6 744 464 736 539 808 491 832 426 847 349 706 385 
7 675 725 713 784 796 737 854 662 690 625 567 639 558 718 
5 232 679 256 767 385 707 400 605 299 626 
