6 166 106 106 147 135 209 240 199 279 149 246 116 
5 164 338 118 423 209 476 350 318 408 220 
5 507 151 454 254 513 282 639 172 566 117 
6 730 334 654 467 783 406 910 294 705 243 698 296 
4 485 436 464 467 520 480 537 438 
7 386 531 359 607 284 561 233 630 376 659 526 663 455 564 
6 672 588 615 633 673 665 779 604 833 554 654 543 
8 893 436 824 495 993 464 941 527 1029 508 1030 591 1048 477 976 421 
5 930 181 960 226 1047 188 995 123 891 138 
5 526 757 468 802 541 845 706 764 600 745 
7 912 762 946 819 1076 756 896 692 826 718 841 790 885 767 
9 153 777 130 822 174 848 185 766 206 801 255 774 236 729 135 710 125 752 
5 502 350 506 369 541 355 583 313 508 318 
4 754 128 771 165 810 149 778 117 
